../../WebCore/platform/DragData.h	..//WKAL//Interfaces/Graphics/BIDragData.h	DragData 
../../WebCore/platform/DragImage.h	..//WKAL//Interfaces/Graphics/BIDragImage.h	 
../../WebCore/platform/graphics/AffineTransform.h	..//WKAL//Interfaces/Graphics/BIAffineTransform.h	AffineTransform 
../../WebCore/platform/graphics/BitmapImage.h	..//WKAL//Interfaces/Graphics/BIBitmapImage.h	BitmapImage FrameData 
../../WebCore/platform/graphics/cairo/GraphicsContextPlatformPrivateCairo.h	..//WKAL//Interfaces/Graphics/BIGraphicsContextPlatformPrivateCairo.h	GraphicsContextPlatformPrivate 
../../WebCore/platform/graphics/Color.h	..//WKAL//Interfaces/Graphics/BIColor.h	Color 
../../WebCore/platform/graphics/FloatPoint3D.h	..//WKAL//Interfaces/Graphics/BIFloatPoint3D.h	FloatPoint3D 
../../WebCore/platform/graphics/FloatPoint.h	..//WKAL//Interfaces/Graphics/BIFloatPoint.h	FloatPoint 
../../WebCore/platform/graphics/FloatRect.h	..//WKAL//Interfaces/Graphics/BIFloatRect.h	FloatRect 
../../WebCore/platform/graphics/FloatSize.h	..//WKAL//Interfaces/Graphics/BIFloatSize.h	FloatSize 
../../WebCore/platform/graphics/GraphicsContext.h	..//WKAL//Interfaces/Graphics/BIGraphicsContext.h	GraphicsContext WindowsBitmap 
../../WebCore/platform/graphics/ImageBuffer.h	..//WKAL//Interfaces/Graphics/BIImageBuffer.h	ImageBuffer 
../../WebCore/platform/graphics/Image.h	..//WKAL//Interfaces/Graphics/BIImage.h	Image 
../../WebCore/platform/graphics/ImageObserver.h	..//WKAL//Interfaces/Graphics/BIImageObserver.h	ImageObserver 
../../WebCore/platform/graphics/ImageSource.h	..//WKAL//Interfaces/Graphics/BIImageSource.h	ImageSource 
../../WebCore/platform/graphics/IntPoint.h	..//WKAL//Interfaces/Graphics/BIIntPoint.h	IntPoint 
../../WebCore/platform/graphics/IntRect.h	..//WKAL//Interfaces/Graphics/BIIntRect.h	IntRect 
../../WebCore/platform/graphics/IntSize.h	..//WKAL//Interfaces/Graphics/BIIntSize.h	IntSize 
../../WebCore/platform/graphics/IntSizeHash.h	..//WKAL//Interfaces/Graphics/BIIntSizeHash.h	 
../../WebCore/platform/graphics/Path.h	..//WKAL//Interfaces/Graphics/BIPath.h	Path PathElement 
../../WebCore/platform/graphics/PathTraversalState.h	..//WKAL//Interfaces/Graphics/BIPathTraversalState.h	PathTraversalState 
../../WebCore/platform/graphics/Pen.h	..//WKAL//Interfaces/Graphics/BIPen.h	Pen 
../../WebCore/platform/image-decoders/bmp/BMPImageDecoder.h	..//OWBAL//Interfaces/ImageDecoder/BIBMPImageDecoder.h	BMPImageDecoder 
../../WebCore/platform/image-decoders/gif/GIFImageDecoder.h	..//OWBAL//Interfaces/ImageDecoder/BIGIFImageDecoder.h	GIFImageDecoder 
../../WebCore/platform/image-decoders/ico/ICOImageDecoder.h	..//OWBAL//Interfaces/ImageDecoder/BIICOImageDecoder.h	ICOImageDecoder 
../../WebCore/platform/image-decoders/ImageDecoder.h	..//OWBAL//Interfaces/ImageDecoder/BIImageDecoder.h	RGBA32Buffer ImageDecoder 
../../WebCore/platform/image-decoders/jpeg/JPEGImageDecoder.h	..//OWBAL//Interfaces/ImageDecoder/BIJPEGImageDecoder.h	JPEGImageDecoder 
../../WebCore/platform/image-decoders/png/PNGImageDecoder.h	..//OWBAL//Interfaces/ImageDecoder/BIPNGImageDecoder.h	PNGImageDecoder 
../../WebCore/platform/image-decoders/xbm/XBMImageDecoder.h	..//OWBAL//Interfaces/ImageDecoder/BIXBMImageDecoder.h	XBMImageDecoder 
../../WebCore/platform/sql/SQLiteAuthorizer.h	..//OWBAL//Interfaces/Database/BISQLiteAuthorizer.h	SQLiteAuthorizer 
../../WebCore/platform/sql/SQLiteDatabase.h	..//OWBAL//Interfaces/Database/BISQLiteDatabase.h	SQLiteDatabase 
../../WebCore/platform/sql/SQLiteStatement.h	..//OWBAL//Interfaces/Database/BISQLiteStatement.h	SQLiteStatement 
../../WebCore/platform/sql/SQLiteTransaction.h	..//OWBAL//Interfaces/Database/BISQLiteTransaction.h	SQLiteTransaction 
../../WebCore/platform/sql/SQLValue.h	..//OWBAL//Interfaces/Database/BISQLValue.h	SQLValue 
../../WebCore/svg/graphics/SVGImageEmptyClients.h	..//WKAL//Interfaces/Graphics/BISVGImageEmptyClients.h	SVGEmptyChromeClient SVGEmptyFrameLoaderClient SVGEmptyEditorClient SVGEmptyContextMenuClient SVGEmptyDragClient SVGEmptyInspectorClient 
../../WebCore/svg/graphics/SVGImage.h	..//WKAL//Interfaces/Graphics/BISVGImage.h	SVGImage 
../../WebCore/svg/graphics/SVGPaintServerGradient.h	..//WKAL//Interfaces/Graphics/BISVGPaintServerGradient.h	SVGPaintServerGradient SharedStopCache 
../../WebCore/svg/graphics/SVGPaintServer.h	..//WKAL//Interfaces/Graphics/BISVGPaintServer.h	SVGPaintServer 
../../WebCore/svg/graphics/SVGPaintServerLinearGradient.h	..//WKAL//Interfaces/Graphics/BISVGPaintServerLinearGradient.h	SVGPaintServerLinearGradient 
../../WebCore/svg/graphics/SVGPaintServerPattern.h	..//WKAL//Interfaces/Graphics/BISVGPaintServerPattern.h	SVGPaintServerPattern 
../../WebCore/svg/graphics/SVGPaintServerRadialGradient.h	..//WKAL//Interfaces/Graphics/BISVGPaintServerRadialGradient.h	SVGPaintServerRadialGradient 
../../WebCore/svg/graphics/SVGPaintServerSolid.h	..//WKAL//Interfaces/Graphics/BISVGPaintServerSolid.h	SVGPaintServerSolid 
../../WebCore/svg/graphics/SVGResourceClipper.h	..//WKAL//Interfaces/Graphics/BISVGResourceClipper.h	ClipDataList SVGResourceClipper ClipData 
../../WebCore/svg/graphics/SVGResourceFilter.h	..//WKAL//Interfaces/Graphics/BISVGResourceFilter.h	SVGResourceFilterPlatformData SVGResourceFilter 
../../WebCore/svg/graphics/SVGResource.h	..//WKAL//Interfaces/Graphics/BISVGResource.h	SVGResource 
../../WebCore/svg/graphics/SVGResourceListener.h	..//WKAL//Interfaces/Graphics/BISVGResourceListener.h	 
../../WebCore/svg/graphics/SVGResourceMarker.h	..//WKAL//Interfaces/Graphics/BISVGResourceMarker.h	SVGResourceMarker 
../../WebCore/svg/graphics/SVGResourceMasker.h	..//WKAL//Interfaces/Graphics/BISVGResourceMasker.h	SVGResourceMasker 
