../../WebCore/platform/graphics/GraphicsContext.h	../WKAL	Graphics
../../WebCore/platform/graphics/FloatSize.h	../WKAL	Graphics
../../WebCore/platform/graphics/IntRect.h	../WKAL	Graphics
../../WebCore/platform/graphics/Image.h	../WKAL	Graphics
../../WebCore/platform/graphics/GraphicsTypes.h	../WKAL	Graphics
../../WebCore/platform/graphics/FloatRect.h	../WKAL	Graphics
../../WebCore/platform/DragData.h	../WKAL	Graphics
../../WebCore/platform/graphics/Color.h	../WKAL	Graphics
../../WebCore/platform/graphics/BitmapImage.h	../WKAL	Graphics
../../WebCore/platform/graphics/FloatPoint3D.h	../WKAL	Graphics
../../WebCore/platform/graphics/FloatPoint.h	../WKAL	Graphics
../../WebCore/platform/DragImage.h	../WKAL	Graphics
../../WebCore/platform/graphics/Pen.h	../WKAL	Graphics
../../WebCore/platform/graphics/SegmentedFontData.h	../WKAL	Graphics
../../WebCore/platform/graphics/Path.h	../WKAL	Graphics
../../WebCore/platform/graphics/PathTraversalState.h	../WKAL	Graphics
../../WebCore/platform/graphics/AffineTransform.h	../WKAL	Graphics
#
#../../WebCore/platform/Arena.h	../OWBAL	Memory
#../../JavaScriptCore/wtf/FastMalloc.h	../OWBAL	Memory
#../../JavaScriptCore/wtf/MallocZoneSupport.h	../OWBAL	Memory
#
../../WebCore/platform/sql/SQLValue.h	../OWBAL	Database
../../WebCore/platform/sql/SQLiteStatement.h	../OWBAL	Database
../../WebCore/platform/sql/SQLiteTransaction.h	../OWBAL	Database
../../WebCore/platform/sql/SQLiteAuthorizer.h	../OWBAL	Database
../../WebCore/platform/sql/SQLiteDatabase.h	../OWBAL	Database
#
../../WebCore/platform/MIMETypeRegistry.h	../OWBAL	Facilities
../../WebCore/platform/SecurityOrigin.h	../OWBAL	Facilities
../../WebCore/platform/SecurityOriginHash.h	../OWBAL	Facilities
../../WebCore/platform/Timer.h	../OWBAL	Facilities
../../WebCore/platform/FileChooser.h	../OWBAL	Facilities
../../WebCore/platform/Language.h	../OWBAL	Facilities
../../WebCore/platform/SharedTimer.h	../OWBAL	Facilities
../../WebCore/platform/StaticConstructors.h	../OWBAL	Facilities
../../WebCore/platform/SystemTime.h	../OWBAL	Facilities
#
../../WebCore/platform/image-decoders/xbm/XBMImageDecoder.h	../OWBAL	ImageDecoder
../../WebCore/platform/image-decoders/jpeg/JPEGImageDecoder.h	../OWBAL	ImageDecoder
../../WebCore/platform/image-decoders/png/PNGImageDecoder.h	../OWBAL	ImageDecoder
../../WebCore/platform/image-decoders/bmp/BMPImageDecoder.h	../OWBAL	ImageDecoder
../../WebCore/platform/image-decoders/gif/GIFImageReader.h	../OWBAL	ImageDecoder
../../WebCore/platform/image-decoders/gif/GIFImageDecoder.h	../OWBAL	ImageDecoder
../../WebCore/platform/image-decoders/ico/ICOImageDecoder.h	../OWBAL	ImageDecoder
#
../../WebCore/platform/text/AtomicString.h	../OWBAL	Internationization
../../WebCore/platform/text/TextCodecICU.h	../OWBAL	Internationization
../../WebCore/platform/text/TextCodec.h	../OWBAL	Internationization
../../WebCore/platform/text/TextCodecUTF16.h	../OWBAL	Internationization
../../WebCore/platform/text/TextCodecLatin1.h	../OWBAL	Internationization
../../WebCore/platform/text/StringImpl.h	../OWBAL	Internationization
../../WebCore/platform/text/RegularExpression.h	../OWBAL	Internationization
../../WebCore/platform/text/CString.h	../OWBAL	Internationization
../../WebCore/platform/text/String.h	../OWBAL	Internationization
../../WebCore/platform/text/SegmentedString.h	../OWBAL	Internationization
../../WebCore/platform/text/UnicodeRange.h	../OWBAL	Internationization
../../WebCore/platform/text/TextStream.h	../OWBAL	Internationization
../../WebCore/platform/text/Base64.h	../OWBAL	Internationization
../../WebCore/platform/text/TextEncoding.h	../OWBAL	Internationization
../../WebCore/platform/text/TextDecoder.h	../OWBAL	Internationization
../../WebCore/platform/text/BidiContext.h	../OWBAL	Internationization
../../WebCore/platform/text/TextCodecUserDefined.h	../OWBAL	Internationization
../../WebCore/platform/text/TextEncodingRegistry.h	../OWBAL	Internationization
../../WebCore/platform/LocalizedStrings.h	../OWBAL	Internationization
#
../../WebCore/platform/SharedBuffer.h	../OWBAL	Type
../../WebCore/platform/DeprecatedPtrList.h	../OWBAL	Type
../../WebCore/platform/DeprecatedPtrListImpl.h	../OWBAL	Type
../../WebCore/platform/DeprecatedPtrQueue.h	../OWBAL	Type
../../WebCore/platform/DeprecatedValueList.h	../OWBAL	Type
../../WebCore/platform/DeprecatedValueListImpl.h	../OWBAL	Type
../../WebCore/platform/FloatConversion.h	../OWBAL	Type
../../WebCore/platform/KURL.h	../OWBAL	Type
../../WebCore/platform/Logging.h	../OWBAL	Type
../../JavaScriptCore/wtf/RefCounted.h	../OWBAL	Type
../../JavaScriptCore/wtf/Platform.h	../OWBAL	Type
../../JavaScriptCore/wtf/VectorTraits.h	../OWBAL	Type
../../JavaScriptCore/wtf/RefPtrHashMap.h	../OWBAL	Type
../../JavaScriptCore/wtf/RefPtr.h	../OWBAL	Type
../../JavaScriptCore/wtf/OwnArrayPtr.h	../OWBAL	Type
../../JavaScriptCore/wtf/Noncopyable.h	../OWBAL	Type
../../JavaScriptCore/wtf/PassRefPtr.h	../OWBAL	Type
../../JavaScriptCore/wtf/OwnPtr.h	../OWBAL	Type
../../JavaScriptCore/wtf/Threading.h	../OWBAL	Type
../../JavaScriptCore/wtf/TCSystemAlloc.h	../OWBAL	Type
../../JavaScriptCore/wtf/Vector.h	../OWBAL	Type
../../JavaScriptCore/wtf/UnusedParam.h	../OWBAL	Type
../../JavaScriptCore/wtf/TCSpinLock.h	../OWBAL	Type
../../JavaScriptCore/wtf/StringExtras.h	../OWBAL	Type
../../JavaScriptCore/wtf/RetainPtr.h	../OWBAL	Type
../../JavaScriptCore/wtf/TCPageMap.h	../OWBAL	Type
../../JavaScriptCore/wtf/TCPackedCache.h	../OWBAL	Type
../../JavaScriptCore/wtf/HashIterators.h	../OWBAL	Type
../../JavaScriptCore/wtf/GetPtr.h	../OWBAL	Type
../../JavaScriptCore/wtf/Forward.h	../OWBAL	Type
../../JavaScriptCore/wtf/HashFunctions.h	../OWBAL	Type
../../JavaScriptCore/wtf/HashCountedSet.h	../OWBAL	Type
../../JavaScriptCore/wtf/Assertions.h	../OWBAL	Type
../../JavaScriptCore/wtf/AlwaysInline.h	../OWBAL	Type
../../JavaScriptCore/wtf/DisallowCType.h	../OWBAL	Type
../../JavaScriptCore/wtf/Deque.h	../OWBAL	Type
../../JavaScriptCore/wtf/MessageQueue.h	../OWBAL	Type
../../JavaScriptCore/wtf/ListRefPtr.h	../OWBAL	Type
../../JavaScriptCore/wtf/ListHashSet.h	../OWBAL	Type
../../JavaScriptCore/wtf/MathExtras.h	../OWBAL	Type
../../JavaScriptCore/wtf/Locker.h	../OWBAL	Type
../../JavaScriptCore/wtf/HashSet.h	../OWBAL	Type
../../JavaScriptCore/wtf/HashMap.h	../OWBAL	Type
../../JavaScriptCore/wtf/HashTraits.h	../OWBAL	Type
../../JavaScriptCore/wtf/HashTable.h	../OWBAL	Type
../../WebCore/platform/CookieJar.h	../OWBAL	Type
../../WebCore/platform/MainThread.h	../OWBAL	Type
../../WebCore/platform/NotImplemented.h	../OWBAL	Type
../../WebCore/platform/SSLKeyGenerator.h	../OWBAL	Type
../../WebCore/platform/ThreadCheck.h	../OWBAL	Type
../../WebCore/platform/TreeShared.h	../OWBAL	Type
#
../../WebCore/platform/graphics/FontFamily.h	../WKAL	Font
../../WebCore/platform/graphics/GlyphPageTreeNode.h	../WKAL	Font
../../WebCore/platform/graphics/GlyphWidthMap.h	../WKAL	Font
../../WebCore/platform/graphics/SimpleFontData.h	../WKAL	Font
../../WebCore/platform/graphics/Font.h	../WKAL	Font
../../WebCore/platform/graphics/FontCache.h	../WKAL	Font
../../WebCore/platform/graphics/FontData.h	../WKAL	Font
../../WebCore/platform/graphics/FontFallbackList.h	../WKAL	Font
../../WebCore/platform/graphics/StringTruncator.h	../WKAL	Font
#
../../WebCore/platform/network/ResourceHandle.h	../WKAL	Network
../../WebCore/platform/network/ResourceRequestBase.h	../WKAL	Network
../../WebCore/platform/network/ResourceResponseBase.h	../WKAL	Network
../../WebCore/platform/network/ResourceErrorBase.h	../WKAL	Network
../../WebCore/platform/network/ProtectionSpace.h	../WKAL	Network
../../WebCore/platform/network/HTTPParsers.h	../WKAL	Network
../../WebCore/platform/network/Credential.h	../WKAL	Network
../../WebCore/platform/network/FormData.h	../WKAL	Network
../../WebCore/platform/network/AuthenticationChallengeBase.h	../WKAL	Network
#
../../WebCore/platform/ContextMenu.h	../WKAL	Widget
../../WebCore/platform/ScrollBar.h	../WKAL	Widget
../../WebCore/platform/Widget.h	../WKAL	Widget
../../WebCore/platform/Cursor.h	../WKAL	Widget
../../WebCore/platform/Pasteboard.h	../WKAL	Widget
../../WebCore/platform/PlatformMenuDescription.h	../WKAL	Widget
../../WebCore/platform/PlatformScreen.h	../WKAL	Widget
../../WebCore/platform/PopupMenu.h	../WKAL	Widget
../../WebCore/platform/PopupMenuClient.h	../WKAL	Widget
../../WebCore/platform/ScrollBar.h	../WKAL	Widget
../../WebCore/platform/ScrollTypes.h	../WKAL	Widget
../../WebCore/platform/ScrollView.h	../WKAL	Widget
../../WebCore/platform/SearchPopupMenu.h	../WKAL	Widget
../../WebCore/platform/WidgetClient.h	../WKAL	Widget
#
../../WebCore/platform/PlatformKeyboardEvent.h	../WKAL	Event
../../WebCore/platform/PlatformMouseEvent.h	../WKAL	Event
../../WebCore/platform/PlatformWheelEvent.h	../WKAL	Event
#
../../WebCore/platform/Sound.h	../OWBAL	Media
../../WebCore/platform/graphics/MediaPlayer.h	../OWBAL	Media
