RGBA32Array	BIRGBA32Array
RGBA32Buffer	BIRGBA32Buffer
ImageDecoder	BIImageDecoder
BMPImageDecoder	BIBMPImageDecoder
GIFImageDecoder	BIGIFImageDecoder
ICOImageDecoder	BIICOImageDecoder
JPEGImageDecoder	BIJPEGImageDecoder
PNGImageDecoder	BIPNGImageDecoder
XBMImageDecoder	BIXBMImageDecoder
SQLiteAuthorizer	BISQLiteAuthorizer
SQLiteDatabase	BISQLiteDatabase
SQLiteStatement	BISQLiteStatement
SQLiteTransaction	BISQLiteTransaction
SQLValue	BISQLValue
DragData	BIDragData
AffineTransform	BIAffineTransform
FrameData	BIFrameData
BitmapImage	BIBitmapImage
RGBA32	BIRGBA32
Color	BIColor
FloatPoint3D	BIFloatPoint3D
FloatPoint	BIFloatPoint
FloatRect	BIFloatRect
FloatSize	BIFloatSize
StrokeStyle	BIStrokeStyle
GraphicsContext	BIGraphicsContext
ImageBuffer	BIImageBuffer
Image	BIImage
ImageObserver	BIImageObserver
NativeImageSourcePtr	BINativeImageSourcePtr
NativeImagePtr	BINativeImagePtr
ImageSource	BIImageSource
IntPoint	BIIntPoint
IntRect	BIIntRect
IntSize	BIIntSize
WindRule	BIWindRule
PathElementType	BIPathElementType
PathElement	BIPathElement
PathApplierFunction	BIPathApplierFunction
Path	BIPath
PathTraversalState	BIPathTraversalState
Pen	BIPen
SVGEmptyChromeClient	BISVGEmptyChromeClient
SVGEmptyFrameLoaderClient	BISVGEmptyFrameLoaderClient
SVGEmptyEditorClient	BISVGEmptyEditorClient
SVGEmptyContextMenuClient	BISVGEmptyContextMenuClient
SVGEmptyDragClient	BISVGEmptyDragClient
SVGEmptyInspectorClient	BISVGEmptyInspectorClient
SVGImage	BISVGImage
SVGGradientSpreadMethod	BISVGGradientSpreadMethod
SVGGradientStop	BISVGGradientStop
SVGPaintServerGradient	BISVGPaintServerGradient
SVGPaintServerType	BISVGPaintServerType
SVGPaintTargetType	BISVGPaintTargetType
SVGPaintServer	BISVGPaintServer
SVGPaintServerLinearGradient	BISVGPaintServerLinearGradient
SVGPaintServerPattern	BISVGPaintServerPattern
SVGPaintServerRadialGradient	BISVGPaintServerRadialGradient
SVGPaintServerSolid	BISVGPaintServerSolid
ClipData	BIClipData
ClipDataList	BIClipDataList
SVGResourceClipper	BISVGResourceClipper
SVGResourceFilterPlatformData	BISVGResourceFilterPlatformData
SVGResourceFilter	BISVGResourceFilter
SVGResourceType	BISVGResourceType
SVGResource	BISVGResource
SVGResourceMarker	BISVGResourceMarker
SVGResourceMasker	BISVGResourceMasker
GraphicsContextPlatformPrivate	BIGraphicsContextPlatformPrivate
